11,10
11111111111
10100010001
10101010101
10101010101
10101010101
10101010101
10101010101
10101010101
10001000101
11111111111