23,27
11111111111111111111111
10000000000100000000001
12111011110101111011121
10111011110101111011101
10000000000000000000001
10111010111111101011101
10000010000100001000001
11111011110101111011111
11111011110101111011111
11111010000000001011111
11111010111111101011111
34444000144444100044443
11111010111111101011111
11111010000000001011111
11111010111111101011111
11111010111111101011111
10000000000100000000001
10111011110101111011101
10111011110101111011101
12001000000400000010021
11101010111111101010111
11101010111111101010111
10000010000100001000001
10111111110101111111101
10111111110101111111101
10000000000000000000001
11111111111111111111111